x,y,n,e,s,w,sx,sy,gx,gy
0,0,0,1,1,1,0,0,3,3
1,0,0,1,1,1,0,0,3,3
2,0,0,1,1,1,0,0,3,3
3,0,0,1,1,1,0,0,3,3
4,0,1,1,1,1,0,0,3,3
0,1,0,1,0,1,0,0,3,3
1,1,1,1,0,1,0,0,3,3
2,1,0,0,0,1,0,0,3,3
3,1,0,0,0,0,0,0,3,3
4,1,0,1,1,0,0,0,3,3
0,2,0,0,0,1,0,0,3,3
1,2,1,0,1,0,0,0,3,3
2,2,0,1,0,0,0,0,3,3
3,2,1,0,1,1,0,0,3,3
4,2,0,1,0,0,0,0,3,3
0,3,0,1,0,1,0,0,3,3
1,3,0,1,1,1,0,0,3,3
2,3,0,1,0,1,0,0,3,3
3,3,1,0,1,1,0,0,3,3
4,3,0,1,0,0,0,0,3,3
0,4,1,1,0,1,0,0,3,3
1,4,1,1,0,1,0,0,3,3
2,4,1,1,0,1,0,0,3,3
3,4,1,1,1,1,0,0,3,3
4,4,1,1,0,1,0,0,3,3
